###########
####  #####
##.     ###
## #### ###
##  .#   ##
## $ $ # ##
##   #  @##
###########
###########
###########
###########