###########
#. ########
# $########
#  ########
#  ##. ####
#    $@####
#  #  #####
###########
###########
###########
###########
