###########
#. . $ ####
# $  #@####
####   ####
###########
###########
###########
###########
###########
###########
###########
