###########
#### .#####
#.    #####
#     #####
####  #####
# $@$######
#    ######
###########
###########
###########
###########
