###########
# . #######
# $ $ #####
#@.   #####
###########
###########
###########
###########
###########
###########
###########
