###########
#  ########
# @ $ .####
#. #.  ####
####$$ ####
####   ####
###########
###########
###########
###########
###########
