###########
# +   .   #
#  $.$    #
#  *$.  $ #
####   $$ #
###.   .  #
###       #
###########
###########
###########
###########
