###########
###########
###########
###########
# ..   ####
#  $ $ ####
####@  ####
###########
###########
###########
###########
