###########
###  @ ####
###  ..####
###  $ ####
#####$ ####
####   ####
####  #####
###########
###########
###########
###########
