###########
##.+#######
##  #######
##$ #######
#      ####
# $$ # ####
##.    ####
###########
###########
###########
###########
