###########
#  ########
#      ####
#.$#@$ ####
#  # # ####
#  #.  ####
###########
###########
###########
###########
###########
