###########
####  #####
##   $#####
##.#  #####
#   #  ####
# @    ####
####   ####
###########
###########
###########
###########