###########
###    ####
###@$$.####
##.    ####
## #$# ####
##.    ####
###########
###########
###########
###########
###########
