11
###########
###########
######  @##
#####  #$##
#  ## ##  #
#      $  #
#. ## ## ##
# ### ## ##
# .      ##
#######  ##
###########
