###########
##  #######
##$.   ####
## ##  ####
#     .####
#  $   ####
##  @  ####
###########
###########
###########
###########
