###########
###########
##    #####
## ##$#####
#@.    ####
# #$ # ####
#    . ####
###########
###########
###########
###########
