###########
#@  #######
#.$ #######
#.  #######
## #   ####
## $ # ####
##     ####
###########
###########
###########
###########
