###########
#####  ####
####@  ####
#### $.####
#### $#####
####. #####
####  #####
###########
###########
###########
###########
