###########
#  #  .####
#  $ # ####
#  #@  ####
#.###  ####
# $    ####
#     #####
###########
###########
###########
###########
