###########
###########
##  .  ####
##     ####
## $ @ ####
## $# #####
# .   #####
#  ########
###########
###########
###########