11
###########
#  .#######
# .$  #####
#   @$ ####
#      ####
#####  ####
#####  ####
###########
###########
###########
###########
