###########
#  ########
#    @ ####
##*    ####
#  $  .####
#    # ####
##     ####
###########
###########
###########
###########
