###########
#  ########
# .$ . ####
## # #@####
#      ####
# $    ####
####  #####
###########
###########
###########
###########
