11
###########
##   #    #
##  $   . #
## @ #    #
#### $ #  #
#    #    #
# .    ####
###########
###########
###########
###########
