11
###########
####   #  #
##   #$   #
##        #
#   ####  #
#  #####  #
#  ########
# .    ####
#@ $.# ####
#      ####
###########
