11
###########
#######  ##
#        ##
#   #$#####
#    @ ####
#..$   ####
#  ########
###########
###########
###########
###########
