11
###########
##   ######
## #$$ ####
## .+  ####
###########
###########
###########
###########
###########
###########
###########
