11
###########
#.  ###   #
#       . #
#   # #   #
##  # # @##
##   $   ##
##    ## ##
## # #  $##
##        #
########  #
###########
