11
###########
###   #####
###   #   #
## .$ #   #
##      ###
##+## #  ##
##       ##
## ## #  ##
##    $  ##
##  #    ##
###########
