11
###########
# @ # .  ##
# # .    ##
#   $ #####
# $## #  ##
#  ##    ##
#  ## #####
##$   #####
## . ######
##   ######
###########
