11
###########
#  #   ####
#@  .    ##
#    $ # ##
#        ##
# #.     ##
#  $   ####
##  #######
##  #######
##  #######
###########
