###########
#.  #######
#.$ #######
#  ########
#$#########
#.   $ ####
###   @####
###########
###########
###########
###########
