###########
###########
###########
###########
#.  #######
# $   #####
# *  @#####
###########
###########
###########
###########
