11
###########
##      ###
##  .     #
##   $  # #
#   #   $ #
#@# #  .# #
#         #
#    ######
#     #####
##    #####
###########
